,index,year,month,week,weekly_new_reg,year-month-week,year-month,cum_reg,cum_reg_norm
0,0,2010,2,7,1,2010-2-7,2010-2,1,9.338114447930673e-06
1,1,2010,3,11,1,2010-3-11,2010-3,2,1.8676228895861346e-05
2,2,2010,3,13,1,2010-3-13,2010-3,3,2.8014343343792023e-05
3,3,2010,4,14,1,2010-4-14,2010-4,4,3.735245779172269e-05
4,4,2010,4,17,1,2010-4-17,2010-4,5,4.669057223965337e-05
5,5,2010,5,20,1,2010-5-20,2010-5,6,5.6028686687584046e-05
6,6,2010,5,21,1,2010-5-21,2010-5,7,6.536680113551472e-05
7,7,2010,6,25,1,2010-6-25,2010-6,8,7.470491558344539e-05
8,8,2010,7,28,1,2010-7-28,2010-7,9,8.404303003137606e-05
9,9,2010,7,30,1,2010-7-30,2010-7,10,9.338114447930674e-05
10,10,2010,9,39,1,2010-9-39,2010-9,11,0.00010271925892723742
11,11,2010,10,41,2,2010-10-41,2010-10,13,0.00012139548782309876
12,12,2010,10,43,3,2010-10-43,2010-10,16,0.00014940983116689077
13,13,2010,12,49,1,2010-12-49,2010-12,17,0.00015874794561482146
14,14,2010,12,51,4,2010-12-51,2010-12,21,0.00019610040340654414
15,15,2011,1,1,1,2011-1-1,2011-1,22,0.00020543851785447483
16,16,2011,1,2,1,2011-1-2,2011-1,23,0.0002147766323024055
17,17,2011,1,4,4,2011-1-4,2011-1,27,0.0002521290900941282
18,18,2011,2,5,4,2011-2-5,2011-2,31,0.0002894815478858509
19,19,2011,2,6,1,2011-2-6,2011-2,32,0.00029881966233378154
20,20,2011,2,7,5,2011-2-7,2011-2,37,0.00034551023457343494
21,21,2011,2,8,3,2011-2-8,2011-2,40,0.00037352457791722696
22,22,2011,3,9,3,2011-3-9,2011-3,43,0.00040153892126101897
23,23,2011,3,11,2,2011-3-11,2011-3,45,0.0004202151501568803
24,24,2011,3,12,1,2011-3-12,2011-3,46,0.000429553264604811
25,25,2011,3,13,4,2011-3-13,2011-3,50,0.0004669057223965337
26,26,2011,4,13,1,2011-4-13,2011-4,51,0.0004762438368444644
27,27,2011,4,14,5,2011-4-14,2011-4,56,0.0005229344090841178
28,28,2011,4,15,10,2011-4-15,2011-4,66,0.0006163155535634245
29,29,2011,4,16,13,2011-4-16,2011-4,79,0.0007377110413865233
30,30,2011,4,17,15,2011-4-17,2011-4,94,0.0008777827581054834
31,31,2011,5,18,11,2011-5-18,2011-5,105,0.0009805020170327208
32,32,2011,5,19,12,2011-5-19,2011-5,117,0.0010925593904078889
33,33,2011,5,20,20,2011-5-20,2011-5,137,0.0012793216793665022
34,34,2011,5,21,36,2011-5-21,2011-5,173,0.0016154937994920066
35,35,2011,5,22,1,2011-5-22,2011-5,174,0.0016248319139399372
36,36,2011,6,22,20,2011-6-22,2011-6,194,0.0018115942028985507
37,37,2011,6,23,46,2011-6-23,2011-6,240,0.0022411474675033617
38,38,2011,6,24,46,2011-6-24,2011-6,286,0.0026707007321081725
39,39,2011,6,25,40,2011-6-25,2011-6,326,0.0030442253100253997
40,40,2011,6,26,47,2011-6-26,2011-6,373,0.0034831166890781414
41,41,2011,7,26,4,2011-7-26,2011-7,377,0.003520469146869864
42,42,2011,7,27,49,2011-7-27,2011-7,426,0.003978036754818467
43,43,2011,7,28,70,2011-7-28,2011-7,496,0.0046317047661736145
44,44,2011,7,29,73,2011-7-29,2011-7,569,0.005313387120872553
45,45,2011,7,30,29,2011-7-30,2011-7,598,0.005584192439862543
46,46,2011,8,31,21,2011-8-31,2011-8,619,0.005780292843269087
47,47,2011,8,32,40,2011-8-32,2011-8,659,0.006153817421186314
48,48,2011,8,33,44,2011-8-33,2011-8,703,0.006564694456895264
49,49,2011,8,34,28,2011-8-34,2011-8,731,0.006826161661437322
50,50,2011,8,35,23,2011-8-35,2011-8,754,0.007040938293739728
51,51,2011,9,35,7,2011-9-35,2011-9,761,0.0071063050948752425
52,52,2011,9,36,18,2011-9-36,2011-9,779,0.007274391154937995
53,53,2011,9,37,16,2011-9-37,2011-9,795,0.007423800986104886
54,54,2011,9,38,28,2011-9-38,2011-9,823,0.007685268190646945
55,55,2011,9,39,46,2011-9-39,2011-9,869,0.008114821455251756
56,56,2011,10,40,42,2011-10-40,2011-10,911,0.008507022262064843
57,57,2011,10,41,37,2011-10-41,2011-10,948,0.008852532496638279
58,58,2011,10,42,25,2011-10-42,2011-10,973,0.009085985357836546
59,59,2011,10,43,23,2011-10-43,2011-10,996,0.009300761990138951
60,60,2011,10,44,4,2011-10-44,2011-10,1000,0.009338114447930673
61,61,2011,11,44,31,2011-11-44,2011-11,1031,0.009627595995816524
62,62,2011,11,45,20,2011-11-45,2011-11,1051,0.009814358284775138
63,63,2011,11,46,25,2011-11-46,2011-11,1076,0.010047811145973405
64,64,2011,11,47,14,2011-11-47,2011-11,1090,0.010178544748244435
65,65,2011,11,48,4,2011-11-48,2011-11,1094,0.010215897206036157
66,66,2011,12,48,11,2011-12-48,2011-12,1105,0.010318616464963395
67,67,2011,12,49,25,2011-12-49,2011-12,1130,0.010552069326161661
68,68,2011,12,50,25,2011-12-50,2011-12,1155,0.010785522187359928
69,69,2011,12,51,28,2011-12-51,2011-12,1183,0.011046989391901987
70,70,2011,12,52,19,2011-12-52,2011-12,1202,0.01122441356641267
71,71,2012,1,1,28,2012-1-1,2012-1,1230,0.01148588077095473
72,72,2012,1,2,23,2012-1-2,2012-1,1253,0.011700657403257134
73,73,2012,1,3,15,2012-1-3,2012-1,1268,0.011840729119976095
74,74,2012,1,4,18,2012-1-4,2012-1,1286,0.012008815180038846
75,75,2012,1,5,4,2012-1-5,2012-1,1290,0.01204616763783057
76,76,2012,2,5,6,2012-2-5,2012-2,1296,0.012102196324518153
77,77,2012,2,6,12,2012-2-6,2012-2,1308,0.01221425369789332
78,78,2012,2,7,8,2012-2-7,2012-2,1316,0.012288958613476767
79,79,2012,2,8,5,2012-2-8,2012-2,1321,0.01233564918571642
80,80,2012,2,9,6,2012-2-9,2012-2,1327,0.012391677872404003
81,81,2012,3,9,12,2012-3-9,2012-3,1339,0.012503735245779172
82,82,2012,3,10,21,2012-3-10,2012-3,1360,0.012699835649185717
83,83,2012,3,11,15,2012-3-11,2012-3,1375,0.012839907365904676
84,84,2012,3,12,45,2012-3-12,2012-3,1420,0.013260122516061557
85,85,2012,3,13,26,2012-3-13,2012-3,1446,0.013502913491707754
86,86,2012,4,14,38,2012-4-14,2012-4,1484,0.01385776184072912
87,87,2012,4,15,29,2012-4-15,2012-4,1513,0.01412856715971911
88,88,2012,4,16,23,2012-4-16,2012-4,1536,0.014343343792021516
89,89,2012,4,17,24,2012-4-17,2012-4,1560,0.014567458538771852
90,90,2012,4,18,3,2012-4-18,2012-4,1563,0.014595472882115643
91,91,2012,5,18,12,2012-5-18,2012-5,1575,0.01470753025549081
92,92,2012,5,19,28,2012-5-19,2012-5,1603,0.01496899746003287
93,93,2012,5,20,26,2012-5-20,2012-5,1629,0.015211788435679068
94,94,2012,5,21,36,2012-5-21,2012-5,1665,0.015547960555804572
95,95,2012,5,22,14,2012-5-22,2012-5,1679,0.0156786941580756
96,96,2012,6,23,32,2012-6-23,2012-6,1711,0.01597751382040938
97,97,2012,6,24,29,2012-6-24,2012-6,1740,0.01624831913939937
98,98,2012,6,25,32,2012-6-25,2012-6,1772,0.016547138801733155
99,99,2012,6,26,29,2012-6-26,2012-6,1801,0.016817944120723145
100,100,2012,7,27,28,2012-7-27,2012-7,1829,0.017079411325265203
101,101,2012,7,28,25,2012-7-28,2012-7,1854,0.01731286418646347
102,102,2012,7,29,29,2012-7-29,2012-7,1883,0.01758366950545346
103,103,2012,7,30,20,2012-7-30,2012-7,1903,0.017770431794412074
104,104,2012,7,31,10,2012-7-31,2012-7,1913,0.017863812938891378
105,105,2012,8,31,16,2012-8-31,2012-8,1929,0.01801322277005827
106,106,2012,8,32,51,2012-8-32,2012-8,1980,0.018489466606902732
107,107,2012,8,33,25,2012-8-33,2012-8,2005,0.018722919468101
108,108,2012,8,34,30,2012-8-34,2012-8,2035,0.01900306290153892
109,109,2012,8,35,28,2012-8-35,2012-8,2063,0.01926453010608098
110,110,2012,9,36,30,2012-9-36,2012-9,2093,0.0195446735395189
111,111,2012,9,37,35,2012-9-37,2012-9,2128,0.019871507545196475
112,112,2012,9,38,41,2012-9-38,2012-9,2169,0.02025437023756163
113,113,2012,9,39,50,2012-9-39,2012-9,2219,0.020721275959958166
114,114,2012,10,40,42,2012-10-40,2012-10,2261,0.021113476766771253
115,115,2012,10,41,64,2012-10-41,2012-10,2325,0.021711116091438817
116,116,2012,10,42,71,2012-10-42,2012-10,2396,0.022374122217241894
117,117,2012,10,43,66,2012-10-43,2012-10,2462,0.022990437770805318
118,118,2012,10,44,41,2012-10-44,2012-10,2503,0.023373300463170477
119,119,2012,11,44,31,2012-11-44,2012-11,2534,0.023662782011056326
120,120,2012,11,45,69,2012-11-45,2012-11,2603,0.024307111907963544
121,121,2012,11,46,76,2012-11-46,2012-11,2679,0.025016808606006274
122,122,2012,11,47,35,2012-11-47,2012-11,2714,0.02534364261168385
123,123,2012,11,48,80,2012-11-48,2012-11,2794,0.0260906917675183
124,124,2012,12,1,14,2012-12-1,2012-12,2808,0.02622142536978933
125,125,2012,12,49,67,2012-12-49,2012-12,2875,0.026847079037800686
126,126,2012,12,50,58,2012-12-50,2012-12,2933,0.027388689675780665
127,127,2012,12,51,61,2012-12-51,2012-12,2994,0.02795831465710444
128,128,2012,12,52,32,2012-12-52,2012-12,3026,0.02825713431943822
129,129,2013,1,1,43,2013-1-1,2013-1,3069,0.028658673240699237
130,130,2013,1,2,117,2013-1-2,2013-1,3186,0.029751232631107127
131,131,2013,1,3,76,2013-1-3,2013-1,3262,0.030460929329149858
132,132,2013,1,4,78,2013-1-4,2013-1,3340,0.03118930225608845
133,133,2013,1,5,62,2013-1-5,2013-1,3402,0.03176826535186015
134,134,2013,2,5,12,2013-2-5,2013-2,3414,0.03188032272523532
135,135,2013,2,6,60,2013-2-6,2013-2,3474,0.03244060959211116
136,136,2013,2,7,56,2013-2-7,2013-2,3530,0.03296354400119528
137,137,2013,2,8,55,2013-2-8,2013-2,3585,0.033477140295831466
138,138,2013,2,9,56,2013-2-9,2013-2,3641,0.03400007470491558
139,139,2013,3,9,13,2013-3-9,2013-3,3654,0.03412147019273868
140,140,2013,3,10,39,2013-3-10,2013-3,3693,0.03448565665620798
141,141,2013,3,11,64,2013-3-11,2013-3,3757,0.03508329598087554
142,142,2013,3,12,46,2013-3-12,2013-3,3803,0.03551284924548035
143,143,2013,3,13,116,2013-3-13,2013-3,3919,0.03659607052144031
144,144,2013,4,14,63,2013-4-14,2013-4,3982,0.03718437173165994
145,145,2013,4,15,100,2013-4-15,2013-4,4082,0.03811818317645301
146,146,2013,4,16,105,2013-4-16,2013-4,4187,0.03909868519348573
147,147,2013,4,17,74,2013-4-17,2013-4,4261,0.0397897056626326
148,148,2013,4,18,39,2013-4-18,2013-4,4300,0.040153892126101896
149,149,2013,5,18,82,2013-5-18,2013-5,4382,0.040919617510832215
150,150,2013,5,19,110,2013-5-19,2013-5,4492,0.041946810100104585
151,151,2013,5,20,95,2013-5-20,2013-5,4587,0.042833930972658
152,152,2013,5,21,144,2013-5-21,2013-5,4731,0.04417861945316002
153,153,2013,5,22,64,2013-5-22,2013-5,4795,0.04477625877782758
154,154,2013,6,23,125,2013-6-23,2013-6,4920,0.04594352308381892
155,155,2013,6,24,134,2013-6-24,2013-6,5054,0.04719483041984163
156,156,2013,6,25,102,2013-6-25,2013-6,5156,0.04814731809353055
157,157,2013,6,26,107,2013-6-26,2013-6,5263,0.04914649633945914
158,158,2013,7,27,67,2013-7-27,2013-7,5330,0.04977215000747049
159,159,2013,7,28,102,2013-7-28,2013-7,5432,0.050724637681159424
160,160,2013,7,29,83,2013-7-29,2013-7,5515,0.05149970118033766
161,161,2013,7,30,86,2013-7-30,2013-7,5601,0.0523027790228597
162,162,2013,7,31,46,2013-7-31,2013-7,5647,0.05273233228746452
163,163,2013,8,31,42,2013-8-31,2013-8,5689,0.0531245330942776
164,164,2013,8,32,124,2013-8-32,2013-8,5813,0.054282459285821004
165,165,2013,8,33,91,2013-8-33,2013-8,5904,0.055132227700582695
166,166,2013,8,34,84,2013-8-34,2013-8,5988,0.05591662931420888
167,167,2013,8,35,98,2013-8-35,2013-8,6086,0.056831764530106084
168,168,2013,9,36,77,2013-9-36,2013-9,6163,0.05755079934259674
169,169,2013,9,37,99,2013-9-37,2013-9,6262,0.05847527267294188
170,170,2013,9,38,134,2013-9-38,2013-9,6396,0.05972658000896459
171,171,2013,9,39,121,2013-9-39,2013-9,6517,0.0608564918571642
172,172,2013,9,40,22,2013-9-40,2013-9,6539,0.061061930375018676
173,173,2013,10,40,79,2013-10-40,2013-10,6618,0.0617996414164052
174,174,2013,10,41,139,2013-10-41,2013-10,6757,0.06309763932466757
175,175,2013,10,42,100,2013-10-42,2013-10,6857,0.06403145076946062
176,176,2013,10,43,65,2013-10-43,2013-10,6922,0.06463842820857613
177,177,2013,10,44,80,2013-10-44,2013-10,7002,0.06538547736441058
178,178,2013,11,44,22,2013-11-44,2013-11,7024,0.06559091588226505
179,179,2013,11,45,92,2013-11-45,2013-11,7116,0.06645002241147467
180,180,2013,11,46,73,2013-11-46,2013-11,7189,0.06713170476617361
181,181,2013,11,47,89,2013-11-47,2013-11,7278,0.06796279695203944
182,182,2013,11,48,51,2013-11-48,2013-11,7329,0.06843904078888391
183,183,2013,12,1,40,2013-12-1,2013-12,7369,0.06881256536680114
184,184,2013,12,49,104,2013-12-49,2013-12,7473,0.06978372926938592
185,185,2013,12,50,85,2013-12-50,2013-12,7558,0.07057746899746004
186,186,2013,12,51,97,2013-12-51,2013-12,7655,0.07148326609890931
187,187,2013,12,52,27,2013-12-52,2013-12,7682,0.07173539518900343
188,188,2014,1,1,66,2014-1-1,2014-1,7748,0.07235171074256685
189,189,2014,1,2,117,2014-1-2,2014-1,7865,0.07344427013297475
190,190,2014,1,3,82,2014-1-3,2014-1,7947,0.07420999551770506
191,191,2014,1,4,78,2014-1-4,2014-1,8025,0.07493836844464366
192,192,2014,1,5,62,2014-1-5,2014-1,8087,0.07551733154041536
193,193,2014,2,5,1,2014-2-5,2014-2,8088,0.0755266696548633
194,194,2014,2,6,51,2014-2-6,2014-2,8139,0.07600291349170775
195,195,2014,2,7,47,2014-2-7,2014-2,8186,0.0764418048707605
196,196,2014,2,8,79,2014-2-8,2014-2,8265,0.07717951591214701
197,197,2014,2,9,57,2014-2-9,2014-2,8322,0.07771178843567907
198,198,2014,3,9,1,2014-3-9,2014-3,8323,0.077721126550127
199,199,2014,3,10,54,2014-3-10,2014-3,8377,0.07822538473031526
200,200,2014,3,11,57,2014-3-11,2014-3,8434,0.0787576572538473
201,201,2014,3,12,81,2014-3-12,2014-3,8515,0.07951404452412969
202,202,2014,3,13,77,2014-3-13,2014-3,8592,0.08023307933662036
203,203,2014,3,14,9,2014-3-14,2014-3,8601,0.08031712236665173
204,204,2014,4,14,64,2014-4-14,2014-4,8665,0.0809147616913193
205,205,2014,4,15,110,2014-4-15,2014-4,8775,0.08194195428059166
206,206,2014,4,16,70,2014-4-16,2014-4,8845,0.08259562229194681
207,207,2014,4,17,47,2014-4-17,2014-4,8892,0.08303451367099955
208,208,2014,4,18,29,2014-4-18,2014-4,8921,0.08330531898998954
209,209,2014,5,18,25,2014-5-18,2014-5,8946,0.08353877185118781
210,210,2014,5,19,52,2014-5-19,2014-5,8998,0.0840243538024802
211,211,2014,5,20,112,2014-5-20,2014-5,9110,0.08507022262064844
212,212,2014,5,21,67,2014-5-21,2014-5,9177,0.0856958762886598
213,213,2014,5,22,62,2014-5-22,2014-5,9239,0.08627483938443149
214,214,2014,6,23,112,2014-6-23,2014-6,9351,0.08732070820259973
215,215,2014,6,24,125,2014-6-24,2014-6,9476,0.08848797250859107
216,216,2014,6,25,88,2014-6-25,2014-6,9564,0.08930972658000896
217,217,2014,6,26,124,2014-6-26,2014-6,9688,0.09046765277155237
218,218,2014,6,27,18,2014-6-27,2014-6,9706,0.09063573883161512
219,219,2014,7,27,56,2014-7-27,2014-7,9762,0.09115867324069923
220,220,2014,7,28,136,2014-7-28,2014-7,9898,0.0924286568056178
221,221,2014,7,29,122,2014-7-29,2014-7,10020,0.09356790676826535
222,222,2014,7,30,71,2014-7-30,2014-7,10091,0.09423091289406843
223,223,2014,7,31,95,2014-7-31,2014-7,10186,0.09511803376662184
224,224,2014,8,31,45,2014-8-31,2014-8,10231,0.09553824891677873
225,225,2014,8,32,114,2014-8-32,2014-8,10345,0.09660279396384282
226,226,2014,8,33,71,2014-8-33,2014-8,10416,0.0972658000896459
227,227,2014,8,34,84,2014-8-34,2014-8,10500,0.09805020170327207
228,228,2014,8,35,82,2014-8-35,2014-8,10582,0.0988159270880024
229,229,2014,9,36,58,2014-9-36,2014-9,10640,0.09935753772598237
230,230,2014,9,37,90,2014-9-37,2014-9,10730,0.10019796802629613
231,231,2014,9,38,117,2014-9-38,2014-9,10847,0.10129052741670402
232,232,2014,9,39,87,2014-9-39,2014-9,10934,0.10210294337367398
233,233,2014,9,40,35,2014-9-40,2014-9,10969,0.10242977737935156
234,234,2014,10,40,54,2014-10-40,2014-10,11023,0.10293403555953982
235,235,2014,10,41,97,2014-10-41,2014-10,11120,0.10383983266098909
236,236,2014,10,42,185,2014-10-42,2014-10,11305,0.10556738383385626
237,237,2014,10,43,147,2014-10-43,2014-10,11452,0.10694008665770208
238,238,2014,10,44,146,2014-10-44,2014-10,11598,0.10830345136709996
239,239,2014,11,45,85,2014-11-45,2014-11,11683,0.10909719109517406
240,240,2014,11,46,89,2014-11-46,2014-11,11772,0.10992828328103989
241,241,2014,11,47,106,2014-11-47,2014-11,11878,0.11091812341252054
242,242,2014,11,48,56,2014-11-48,2014-11,11934,0.11144105782160466
243,243,2014,12,1,62,2014-12-1,2014-12,11996,0.11202002091737637
244,244,2014,12,49,78,2014-12-49,2014-12,12074,0.11274839384431495
245,245,2014,12,50,121,2014-12-50,2014-12,12195,0.11387830569251457
246,246,2014,12,51,87,2014-12-51,2014-12,12282,0.11469072164948453
247,247,2014,12,52,68,2014-12-52,2014-12,12350,0.11532571343194382
248,248,2015,1,1,10,2015-1-1,2015-1,12360,0.11541909457642313
249,249,2015,1,2,105,2015-1-2,2015-1,12465,0.11639959659345585
250,250,2015,1,3,101,2015-1-3,2015-1,12566,0.11734274615269685
251,251,2015,1,4,105,2015-1-4,2015-1,12671,0.11832324816972957
252,252,2015,1,5,103,2015-1-5,2015-1,12774,0.11928507395786643
253,253,2015,2,6,120,2015-2-6,2015-2,12894,0.12040564769161811
254,254,2015,2,7,41,2015-2-7,2015-2,12935,0.12078851038398326
255,255,2015,2,8,41,2015-2-8,2015-2,12976,0.12117137307634843
256,256,2015,2,9,57,2015-2-9,2015-2,13033,0.12170364559988048
257,257,2015,3,10,71,2015-3-10,2015-3,13104,0.12236665172568355
258,258,2015,3,11,66,2015-3-11,2015-3,13170,0.12298296727924697
259,259,2015,3,12,67,2015-3-12,2015-3,13237,0.12360862094725833
260,260,2015,3,13,67,2015-3-13,2015-3,13304,0.12423427461526969
261,261,2015,3,14,17,2015-3-14,2015-3,13321,0.12439302256088451
262,262,2015,4,14,78,2015-4-14,2015-4,13399,0.1251213954878231
263,263,2015,4,15,102,2015-4-15,2015-4,13501,0.12607388316151202
264,264,2015,4,16,55,2015-4-16,2015-4,13556,0.1265874794561482
265,265,2015,4,17,111,2015-4-17,2015-4,13667,0.12762401015986852
266,266,2015,4,18,98,2015-4-18,2015-4,13765,0.12853914537576572
267,267,2015,5,18,10,2015-5-18,2015-5,13775,0.12863252652024504
268,268,2015,5,19,47,2015-5-19,2015-5,13822,0.12907141789929777
269,269,2015,5,20,57,2015-5-20,2015-5,13879,0.12960369042282982
270,270,2015,5,21,113,2015-5-21,2015-5,13992,0.130658897355446
271,271,2015,5,22,43,2015-5-22,2015-5,14035,0.13106043627670702
272,272,2015,6,23,77,2015-6-23,2015-6,14112,0.13177947108919766
273,273,2015,6,24,224,2015-6-24,2015-6,14336,0.13387120872553415
274,274,2015,6,25,77,2015-6-25,2015-6,14413,0.1345902435380248
275,275,2015,6,26,97,2015-6-26,2015-6,14510,0.13549604063947407
276,276,2015,6,27,45,2015-6-27,2015-6,14555,0.13591625578963096
277,277,2015,7,27,27,2015-7-27,2015-7,14582,0.13616838487972507
278,278,2015,7,28,73,2015-7-28,2015-7,14655,0.13685006723442403
279,279,2015,7,29,241,2015-7-29,2015-7,14896,0.13910055281637532
280,280,2015,7,30,128,2015-7-30,2015-7,15024,0.14029583146571045
281,281,2015,7,31,53,2015-7-31,2015-7,15077,0.14079075153145076
282,282,2015,8,32,54,2015-8-32,2015-8,15131,0.14129500971163902
283,283,2015,8,33,81,2015-8-33,2015-8,15212,0.1420513969819214
284,284,2015,8,34,58,2015-8-34,2015-8,15270,0.1425930076199014
285,285,2015,8,35,74,2015-8-35,2015-8,15344,0.14328402808904825
286,286,2015,8,36,13,2015-8-36,2015-8,15357,0.14340542357687136
287,287,2015,9,36,55,2015-9-36,2015-9,15412,0.14391901987150754
288,288,2015,9,37,56,2015-9-37,2015-9,15468,0.14444195428059167
289,289,2015,9,38,78,2015-9-38,2015-9,15546,0.14517032720753026
290,290,2015,9,39,64,2015-9-39,2015-9,15610,0.1457679665321978
291,291,2015,9,40,33,2015-9-40,2015-9,15643,0.14607612430897954
292,292,2015,10,40,41,2015-10-40,2015-10,15684,0.1464589870013447
293,293,2015,10,41,88,2015-10-41,2015-10,15772,0.1472807410727626
294,294,2015,10,42,79,2015-10-42,2015-10,15851,0.1480184521141491
295,295,2015,10,43,77,2015-10-43,2015-10,15928,0.14873748692663977
296,296,2015,10,44,85,2015-10-44,2015-10,16013,0.14953122665471388
297,297,2015,11,45,59,2015-11-45,2015-11,16072,0.15008217540714178
298,298,2015,11,46,92,2015-11-46,2015-11,16164,0.15094128193635142
299,299,2015,11,47,66,2015-11-47,2015-11,16230,0.15155759748991485
300,300,2015,11,48,51,2015-11-48,2015-11,16281,0.1520338413267593
301,301,2015,11,49,8,2015-11-49,2015-11,16289,0.15210854624234274
302,302,2015,12,49,74,2015-12-49,2015-12,16363,0.15279956671148962
303,303,2015,12,50,124,2015-12-50,2015-12,16487,0.153957492903033
304,304,2015,12,51,74,2015-12-51,2015-12,16561,0.15464851337217989
305,305,2015,12,52,66,2015-12-52,2015-12,16627,0.1552648289257433
306,306,2015,12,53,82,2015-12-53,2015-12,16709,0.15603055431047363
307,307,2016,1,1,92,2016-1-1,2016-1,16801,0.15688966083968325
308,308,2016,1,2,105,2016-1-2,2016-1,16906,0.15787016285671598
309,309,2016,1,3,125,2016-1-3,2016-1,17031,0.1590374271627073
310,310,2016,1,4,70,2016-1-4,2016-1,17101,0.15969109517406246
311,311,2016,1,53,3,2016-1-53,2016-1,17104,0.15971910951740625
312,312,2016,2,5,58,2016-2-5,2016-2,17162,0.16026072015538623
313,313,2016,2,6,77,2016-2-6,2016-2,17239,0.1609797549678769
314,314,2016,2,7,77,2016-2-7,2016-2,17316,0.16169878978036756
315,315,2016,2,8,72,2016-2-8,2016-2,17388,0.16237113402061856
316,316,2016,2,9,9,2016-2-9,2016-2,17397,0.16245517705064993
317,317,2016,3,9,59,2016-3-9,2016-3,17456,0.16300612580307786
318,318,2016,3,10,55,2016-3-10,2016-3,17511,0.16351972209771404
319,319,2016,3,11,85,2016-3-11,2016-3,17596,0.16431346182578813
320,320,2016,3,12,98,2016-3-12,2016-3,17694,0.16522859704168535
321,321,2016,3,13,60,2016-3-13,2016-3,17754,0.1657888839085612
322,322,2016,4,13,7,2016-4-13,2016-4,17761,0.1658542507096967
323,323,2016,4,14,147,2016-4-14,2016-4,17908,0.1672269535335425
324,324,2016,4,15,121,2016-4-15,2016-4,18029,0.16835686538174213
325,325,2016,4,16,123,2016-4-16,2016-4,18152,0.16950545345883758
326,326,2016,4,17,99,2016-4-17,2016-4,18251,0.17042992678918273
327,327,2016,5,18,87,2016-5-18,2016-5,18338,0.1712423427461527
328,328,2016,5,19,73,2016-5-19,2016-5,18411,0.17192402510085164
329,329,2016,5,20,87,2016-5-20,2016-5,18498,0.1727364410578216
330,330,2016,5,21,76,2016-5-21,2016-5,18574,0.17344613775586434
331,331,2016,5,22,28,2016-5-22,2016-5,18602,0.17370760496040638
332,332,2016,6,22,58,2016-6-22,2016-6,18660,0.17424921559838638
333,333,2016,6,23,114,2016-6-23,2016-6,18774,0.17531376064545048
334,334,2016,6,24,111,2016-6-24,2016-6,18885,0.17635029134917077
335,335,2016,6,25,118,2016-6-25,2016-6,19003,0.17745218885402658
336,336,2016,6,26,111,2016-6-26,2016-6,19114,0.1784887195577469
337,337,2016,7,26,28,2016-7-26,2016-7,19142,0.17875018676228896
338,338,2016,7,27,85,2016-7-27,2016-7,19227,0.17954392649036308
339,339,2016,7,28,149,2016-7-28,2016-7,19376,0.18093530554310475
340,340,2016,7,29,132,2016-7-29,2016-7,19508,0.1821679366502316
341,341,2016,7,30,151,2016-7-30,2016-7,19659,0.1835779919318691
342,342,2016,8,31,185,2016-8-31,2016-8,19844,0.1853055431047363
343,343,2016,8,32,116,2016-8-32,2016-8,19960,0.18638876438069624
344,344,2016,8,33,145,2016-8-33,2016-8,20105,0.1877427909756462
345,345,2016,8,34,133,2016-8-34,2016-8,20238,0.18898476019722096
346,346,2016,8,35,53,2016-8-35,2016-8,20291,0.1894796802629613
347,347,2016,9,35,30,2016-9-35,2016-9,20321,0.1897598236963992
348,348,2016,9,36,107,2016-9-36,2016-9,20428,0.1907590019423278
349,349,2016,9,37,154,2016-9-37,2016-9,20582,0.19219707156730914
350,350,2016,9,38,119,2016-9-38,2016-9,20701,0.19330830718661288
351,351,2016,9,39,119,2016-9-39,2016-9,20820,0.19441954280591664
352,352,2016,10,39,1,2016-10-39,2016-10,20821,0.19442888092036456
353,353,2016,10,40,182,2016-10-40,2016-10,21003,0.19612841774988793
354,354,2016,10,41,127,2016-10-41,2016-10,21130,0.19731435828477514
355,355,2016,10,42,231,2016-10-42,2016-10,21361,0.1994714627222471
356,356,2016,10,43,136,2016-10-43,2016-10,21497,0.2007414462871657
357,357,2016,10,44,10,2016-10-44,2016-10,21507,0.200834827431645
358,358,2016,11,44,101,2016-11-44,2016-11,21608,0.201777976990886
359,359,2016,11,45,79,2016-11-45,2016-11,21687,0.20251568803227252
360,360,2016,11,46,110,2016-11-46,2016-11,21797,0.2035428806215449
361,361,2016,11,47,90,2016-11-47,2016-11,21887,0.20438331092185866
362,362,2016,11,48,39,2016-11-48,2016-11,21926,0.20474749738532796
363,363,2016,12,48,31,2016-12-48,2016-12,21957,0.2050369789332138
364,364,2016,12,49,160,2016-12-49,2016-12,22117,0.2065310772448827
365,365,2016,12,50,79,2016-12-50,2016-12,22196,0.20726878828626924
366,366,2016,12,51,137,2016-12-51,2016-12,22333,0.20854810996563575
367,367,2016,12,52,123,2016-12-52,2016-12,22456,0.20969669804273122
368,368,2017,1,1,182,2017-1-1,2017-1,22638,0.2113962348722546
369,369,2017,1,2,104,2017-1-2,2017-1,22742,0.21236739877483937
370,370,2017,1,3,156,2017-1-3,2017-1,22898,0.21382414462871657
371,371,2017,1,4,121,2017-1-4,2017-1,23019,0.21495405647691618
372,372,2017,1,5,87,2017-1-5,2017-1,23106,0.21576647243388614
373,373,2017,2,5,158,2017-2-5,2017-2,23264,0.2172418945166592
374,374,2017,2,6,145,2017-2-6,2017-2,23409,0.21859592111160914
375,375,2017,2,7,144,2017-2-7,2017-2,23553,0.21994060959211117
376,376,2017,2,8,90,2017-2-8,2017-2,23643,0.22078103989242492
377,377,2017,2,9,43,2017-2-9,2017-2,23686,0.22118257881368594
378,378,2017,3,9,79,2017-3-9,2017-3,23765,0.22192028985507245
379,379,2017,3,10,167,2017-3-10,2017-3,23932,0.2234797549678769
380,380,2017,3,11,123,2017-3-11,2017-3,24055,0.22462834304497237
381,381,2017,3,12,117,2017-3-12,2017-3,24172,0.22572090243538026
382,382,2017,3,13,148,2017-3-13,2017-3,24320,0.22710294337367398
383,383,2017,4,14,190,2017-4-14,2017-4,24510,0.22887718511878083
384,384,2017,4,15,234,2017-4-15,2017-4,24744,0.2310623038995966
385,385,2017,4,16,168,2017-4-16,2017-4,24912,0.23263110712684895
386,386,2017,4,17,152,2017-4-17,2017-4,25064,0.2340505005229344
387,387,2017,5,18,206,2017-5-18,2017-5,25270,0.23597415209920813
388,388,2017,5,19,175,2017-5-19,2017-5,25445,0.237608322127596
389,389,2017,5,20,139,2017-5-20,2017-5,25584,0.23890632003585835
390,390,2017,5,21,172,2017-5-21,2017-5,25756,0.24051247572090242
391,391,2017,5,22,40,2017-5-22,2017-5,25796,0.24088600029881965
392,392,2017,6,22,84,2017-6-22,2017-6,25880,0.24167040191244585
393,393,2017,6,23,167,2017-6-23,2017-6,26047,0.24322986702525026
394,394,2017,6,24,230,2017-6-24,2017-6,26277,0.2453776333482743
395,395,2017,6,25,132,2017-6-25,2017-6,26409,0.24661026445540116
396,396,2017,6,26,211,2017-6-26,2017-6,26620,0.24858060660391454
397,397,2017,7,26,1,2017-7-26,2017-7,26621,0.24858994471836246
398,398,2017,7,27,147,2017-7-27,2017-7,26768,0.2499626475422083
399,399,2017,7,28,212,2017-7-28,2017-7,26980,0.25194232780516956
400,400,2017,7,29,145,2017-7-29,2017-7,27125,0.25329635440011955
401,401,2017,7,30,137,2017-7-30,2017-7,27262,0.25457567607948606
402,402,2017,7,31,19,2017-7-31,2017-7,27281,0.2547531002539967
403,403,2017,8,31,133,2017-8-31,2017-8,27414,0.2559950694755715
404,404,2017,8,32,171,2017-8-32,2017-8,27585,0.25759188704616764
405,405,2017,8,33,128,2017-8-33,2017-8,27713,0.25878716569550275
406,406,2017,8,34,120,2017-8-34,2017-8,27833,0.25990773942925444
407,407,2017,8,35,124,2017-8-35,2017-8,27957,0.26106566562079786
408,408,2017,9,35,41,2017-9-35,2017-9,27998,0.261448528313163
409,409,2017,9,36,122,2017-9-36,2017-9,28120,0.26258777827581053
410,410,2017,9,37,156,2017-9-37,2017-9,28276,0.2640445241296877
411,411,2017,9,38,243,2017-9-38,2017-9,28519,0.2663136859405349
412,412,2017,9,39,166,2017-9-39,2017-9,28685,0.2678638129388914
413,413,2017,10,40,236,2017-10-40,2017-10,28921,0.270067607948603
414,414,2017,10,41,183,2017-10-41,2017-10,29104,0.27177648289257433
415,415,2017,10,42,170,2017-10-42,2017-10,29274,0.27336396234872257
416,416,2017,10,43,146,2017-10-43,2017-10,29420,0.2747273270581204
417,417,2017,10,44,42,2017-10-44,2017-10,29462,0.2751195278649335
418,418,2017,11,44,61,2017-11-44,2017-11,29523,0.2756891528462573
419,419,2017,11,45,133,2017-11-45,2017-11,29656,0.27693112206783205
420,420,2017,11,46,135,2017-11-46,2017-11,29791,0.2781917675183027
421,421,2017,11,47,106,2017-11-47,2017-11,29897,0.27918160764978334
422,422,2017,11,48,134,2017-11-48,2017-11,30031,0.2804329149858061
423,423,2017,12,48,29,2017-12-48,2017-12,30060,0.28070372030479607
424,424,2017,12,49,176,2017-12-49,2017-12,30236,0.2823472284476319
425,425,2017,12,50,168,2017-12-50,2017-12,30404,0.2839160316748842
426,426,2017,12,51,138,2017-12-51,2017-12,30542,0.28520469146869865
427,427,2017,12,52,118,2017-12-52,2017-12,30660,0.28630658897355443
428,428,2018,1,1,186,2018-1-1,2018-1,30846,0.28804347826086957
429,429,2018,1,2,268,2018-1-2,2018-1,31114,0.290546092932915
430,430,2018,1,3,173,2018-1-3,2018-1,31287,0.292161586732407
431,431,2018,1,4,187,2018-1-4,2018-1,31474,0.29390781413417005
432,432,2018,1,5,109,2018-1-5,2018-1,31583,0.2949256686089945
433,433,2018,2,5,63,2018-2-5,2018-2,31646,0.29551396981921413
434,434,2018,2,6,122,2018-2-6,2018-2,31768,0.29665321978186165
435,435,2018,2,7,114,2018-2-7,2018-2,31882,0.29771776482892576
436,436,2018,2,8,132,2018-2-8,2018-2,32014,0.2989503959360526
437,437,2018,2,9,71,2018-2-9,2018-2,32085,0.29961340206185566
438,438,2018,3,9,45,2018-3-9,2018-3,32130,0.30003361721201255
439,439,2018,3,10,129,2018-3-10,2018-3,32259,0.30123823397579563
440,440,2018,3,11,163,2018-3-11,2018-3,32422,0.3027603466308083
441,441,2018,3,12,215,2018-3-12,2018-3,32637,0.30476804123711343
442,442,2018,3,13,235,2018-3-13,2018-3,32872,0.30696249813237714
443,443,2018,4,14,233,2018-4-14,2018-4,33105,0.30913827879874495
444,444,2018,4,15,253,2018-4-15,2018-4,33358,0.3115008217540714
445,445,2018,4,16,209,2018-4-16,2018-4,33567,0.31345248767368894
446,446,2018,4,17,156,2018-4-17,2018-4,33723,0.3149092335275661
447,447,2018,4,18,14,2018-4-18,2018-4,33737,0.3150399671298371
448,448,2018,5,18,180,2018-5-18,2018-5,33917,0.31672082773046467
449,449,2018,5,19,259,2018-5-19,2018-5,34176,0.3191393993724787
450,450,2018,5,20,243,2018-5-20,2018-5,34419,0.32140856118332584
451,451,2018,5,21,306,2018-5-21,2018-5,34725,0.32426602420439266
452,452,2018,5,22,206,2018-5-22,2018-5,34931,0.3261896757806664
453,453,2018,6,22,69,2018-6-22,2018-6,35000,0.3268340056775736
454,454,2018,6,23,352,2018-6-23,2018-6,35352,0.33012102196324516
455,455,2018,6,24,269,2018-6-24,2018-6,35621,0.3326329747497385
456,456,2018,6,25,250,2018-6-25,2018-6,35871,0.3349675033617212
457,457,2018,6,26,203,2018-6-26,2018-6,36074,0.3368631405946511
458,458,2018,7,27,147,2018-7-27,2018-7,36221,0.33823584341849694
459,459,2018,7,28,228,2018-7-28,2018-7,36449,0.34036493351262515
460,460,2018,7,29,211,2018-7-29,2018-7,36660,0.3423352756611385
461,461,2018,7,30,218,2018-7-30,2018-7,36878,0.3443709846107874
462,462,2018,7,31,49,2018-7-31,2018-7,36927,0.344828552218736
463,463,2018,8,31,142,2018-8-31,2018-8,37069,0.34615456447034215
464,464,2018,8,32,186,2018-8-32,2018-8,37255,0.34789145375765723
465,465,2018,8,33,176,2018-8-33,2018-8,37431,0.34953496190049305
466,466,2018,8,34,157,2018-8-34,2018-8,37588,0.3510010458688182
467,467,2018,8,35,204,2018-8-35,2018-8,37792,0.352906021216196
468,468,2018,9,36,187,2018-9-36,2018-9,37979,0.3546522486179591
469,469,2018,9,37,205,2018-9-37,2018-9,38184,0.3565665620797849
470,470,2018,9,38,234,2018-9-38,2018-9,38418,0.3587516808606006
471,471,2018,9,39,304,2018-9-39,2018-9,38722,0.36159046765277153
472,472,2018,10,40,388,2018-10-40,2018-10,39110,0.36521365605856865
473,473,2018,10,41,407,2018-10-41,2018-10,39517,0.36901426863887643
474,474,2018,10,42,346,2018-10-42,2018-10,39863,0.3722452562378605
475,475,2018,10,43,352,2018-10-43,2018-10,40215,0.37553227252353205
476,476,2018,10,44,196,2018-10-44,2018-10,40411,0.37736254295532645
477,477,2018,11,44,195,2018-11-44,2018-11,40606,0.37918347527267293
478,478,2018,11,45,374,2018-11-45,2018-11,40980,0.382675930076199
479,479,2018,11,46,424,2018-11-46,2018-11,41404,0.3866352906021216
480,480,2018,11,47,255,2018-11-47,2018-11,41659,0.38901650978634394
481,481,2018,11,48,396,2018-11-48,2018-11,42055,0.3927144031077245
482,482,2018,12,1,23,2018-12-1,2018-12,42078,0.3929291797400269
483,483,2018,12,49,337,2018-12-49,2018-12,42415,0.39607612430897954
484,484,2018,12,50,420,2018-12-50,2018-12,42835,0.3999981323771104
485,485,2018,12,51,422,2018-12-51,2018-12,43257,0.40393881667413717
486,486,2018,12,52,275,2018-12-52,2018-12,43532,0.4065067981473181
487,487,2019,1,1,296,2019-1-1,2019-1,43828,0.40927088002390555
488,488,2019,1,2,430,2019-1-2,2019-1,44258,0.41328626923651574
489,489,2019,1,3,407,2019-1-3,2019-1,44665,0.4170868818168236
490,490,2019,1,4,387,2019-1-4,2019-1,45052,0.4207007321081727
491,491,2019,1,5,178,2019-1-5,2019-1,45230,0.42236291647990437
492,492,2019,2,5,41,2019-2-5,2019-2,45271,0.4227457791722695
493,493,2019,2,6,278,2019-2-6,2019-2,45549,0.4253417749887943
494,494,2019,2,7,142,2019-2-7,2019-2,45691,0.42666778724040044
495,495,2019,2,8,107,2019-2-8,2019-2,45798,0.427666965486329
496,496,2019,2,9,136,2019-2-9,2019-2,45934,0.4289369490512476
497,497,2019,3,9,17,2019-3-9,2019-3,45951,0.4290956969968624
498,498,2019,3,10,133,2019-3-10,2019-3,46084,0.43033766621843716
499,499,2019,3,11,124,2019-3-11,2019-3,46208,0.4314955924099806
500,500,2019,3,12,104,2019-3-12,2019-3,46312,0.43246675631256537
501,501,2019,3,13,159,2019-3-13,2019-3,46471,0.43395151650978636
502,502,2019,4,14,184,2019-4-14,2019-4,46655,0.4356697295682056
503,503,2019,4,15,243,2019-4-15,2019-4,46898,0.43793889137905273
504,504,2019,4,16,431,2019-4-16,2019-4,47329,0.44196361870611084
505,505,2019,4,17,292,2019-4-17,2019-4,47621,0.4446903481249066
506,506,2019,4,18,73,2019-4-18,2019-4,47694,0.44537203047960555
507,507,2019,5,18,119,2019-5-18,2019-5,47813,0.4464832660989093
508,508,2019,5,19,187,2019-5-19,2019-5,48000,0.44822949350067237
509,509,2019,5,20,210,2019-5-20,2019-5,48210,0.4501904975347378
510,510,2019,5,21,224,2019-5-21,2019-5,48434,0.45228223517107424
511,511,2019,5,22,138,2019-5-22,2019-5,48572,0.45357089496488867
512,512,2019,6,23,249,2019-6-23,2019-6,48821,0.45589608546242344
513,513,2019,6,24,212,2019-6-24,2019-6,49033,0.45787576572538474
514,514,2019,6,25,284,2019-6-25,2019-6,49317,0.460527790228597
515,515,2019,6,26,311,2019-6-26,2019-6,49628,0.4634319438219035
516,516,2019,7,27,183,2019-7-27,2019-7,49811,0.4651408187658748
517,517,2019,7,28,246,2019-7-28,2019-7,50057,0.4674379949200657
518,518,2019,7,29,378,2019-7-29,2019-7,50435,0.4709678021813835
519,519,2019,7,30,232,2019-7-30,2019-7,50667,0.47313424473330346
520,520,2019,7,31,140,2019-7-31,2019-7,50807,0.4744415807560137
521,521,2019,8,31,72,2019-8-31,2019-8,50879,0.47511392499626476
522,522,2019,8,32,117,2019-8-32,2019-8,50996,0.4762064843866726
523,523,2019,8,33,241,2019-8-33,2019-8,51237,0.4784569699686239
524,524,2019,8,34,236,2019-8-34,2019-8,51473,0.4806607649783356
525,525,2019,8,35,215,2019-8-35,2019-8,51688,0.48266845958464066
526,526,2019,9,36,231,2019-9-36,2019-9,51919,0.48482556402211263
527,527,2019,9,37,240,2019-9-37,2019-9,52159,0.487066711489616
528,528,2019,9,38,224,2019-9-38,2019-9,52383,0.48915844912595247
529,529,2019,9,39,247,2019-9-39,2019-9,52630,0.49146496339459134
530,530,2019,9,40,10,2019-9-40,2019-9,52640,0.49155834453907066
531,531,2019,10,40,435,2019-10-40,2019-10,53075,0.4956204243239205
532,532,2019,10,41,296,2019-10-41,2019-10,53371,0.498384506200508
533,533,2019,10,42,531,2019-10-42,2019-10,53902,0.5033430449723592
534,534,2019,10,43,282,2019-10-43,2019-10,54184,0.5059763932466756
535,535,2019,10,44,111,2019-10-44,2019-10,54295,0.507012923950396
536,536,2019,11,44,34,2019-11-44,2019-11,54329,0.5073304198416255
537,537,2019,11,45,156,2019-11-45,2019-11,54485,0.5087871656955028
538,538,2019,11,46,114,2019-11-46,2019-11,54599,0.5098517107425669
539,539,2019,11,47,148,2019-11-47,2019-11,54747,0.5112337516808606
540,540,2019,11,48,85,2019-11-48,2019-11,54832,0.5120274914089347
541,541,2019,12,1,176,2019-12-1,2019-12,55008,0.5136709995517705
542,542,2019,12,49,126,2019-12-49,2019-12,55134,0.5148476019722098
543,543,2019,12,50,200,2019-12-50,2019-12,55334,0.5167152248617959
544,544,2019,12,51,289,2019-12-51,2019-12,55623,0.5194139399372478
545,545,2019,12,52,66,2019-12-52,2019-12,55689,0.5200302554908113
546,546,2020,1,1,141,2020-1-1,2020-1,55830,0.5213469296279695
547,547,2020,1,2,906,2020-1-2,2020-1,56736,0.5298072613177948
548,548,2020,1,3,268,2020-1-3,2020-1,57004,0.5323098759898401
549,549,2020,1,4,644,2020-1-4,2020-1,57648,0.5383236216943075
550,550,2020,1,5,129,2020-1-5,2020-1,57777,0.5395282384580905
551,551,2020,2,5,2,2020-2-5,2020-2,57779,0.5395469146869865
552,552,2020,2,6,142,2020-2-6,2020-2,57921,0.5408729269385926
553,553,2020,2,7,143,2020-2-7,2020-2,58064,0.5422082773046466
554,554,2020,2,8,130,2020-2-8,2020-2,58194,0.5434222321828777
555,555,2020,2,9,107,2020-2-9,2020-2,58301,0.5444214104288062
556,556,2020,3,10,143,2020-3-10,2020-3,58444,0.5457567607948604
557,557,2020,3,11,198,2020-3-11,2020-3,58642,0.5476057074555506
558,558,2020,3,12,221,2020-3-12,2020-3,58863,0.5496694307485432
559,559,2020,3,13,244,2020-3-13,2020-3,59107,0.5519479306738383
560,560,2020,3,14,183,2020-3-14,2020-3,59290,0.5536568056178096
561,561,2020,4,14,115,2020-4-14,2020-4,59405,0.5547306887793216
562,562,2020,4,15,292,2020-4-15,2020-4,59697,0.5574574181981174
563,563,2020,4,16,119,2020-4-16,2020-4,59816,0.5585686538174212
564,564,2020,4,17,62,2020-4-17,2020-4,59878,0.5591476169131929
565,565,2020,4,18,52,2020-4-18,2020-4,59930,0.5596331988644853
566,566,2020,5,18,14,2020-5-18,2020-5,59944,0.5597639324667563
567,567,2020,5,19,62,2020-5-19,2020-5,60006,0.560342895562528
568,568,2020,5,20,55,2020-5-20,2020-5,60061,0.5608564918571642
569,569,2020,5,21,50,2020-5-21,2020-5,60111,0.5613233975795607
570,570,2020,5,22,77,2020-5-22,2020-5,60188,0.5620424323920514
571,571,2020,6,23,104,2020-6-23,2020-6,60292,0.5630135962946362
572,572,2020,6,24,109,2020-6-24,2020-6,60401,0.5640314507694606
573,573,2020,6,25,89,2020-6-25,2020-6,60490,0.5648625429553265
574,574,2020,6,26,190,2020-6-26,2020-6,60680,0.5666367847004333
575,575,2020,6,27,25,2020-6-27,2020-6,60705,0.5668702375616316
576,576,2020,7,27,101,2020-7-27,2020-7,60806,0.5678133871208726
577,577,2020,7,28,245,2020-7-28,2020-7,61051,0.5701012251606156
578,578,2020,7,29,362,2020-7-29,2020-7,61413,0.5734816225907665
579,579,2020,7,30,391,2020-7-30,2020-7,61804,0.5771328253399074
580,580,2020,7,31,430,2020-7-31,2020-7,62234,0.5811482145525175
581,581,2020,8,31,1,2020-8-31,2020-8,62235,0.5811575526669654
582,582,2020,8,32,282,2020-8-32,2020-8,62517,0.5837909009412819
583,583,2020,8,33,93,2020-8-33,2020-8,62610,0.5846593455849395
584,584,2020,8,34,189,2020-8-34,2020-8,62799,0.5864242492155984
585,585,2020,8,35,160,2020-8-35,2020-8,62959,0.5879183475272673
586,586,2020,8,36,18,2020-8-36,2020-8,62977,0.58808643358733
587,587,2020,9,36,126,2020-9-36,2020-9,63103,0.5892630360077693
588,588,2020,9,37,115,2020-9-37,2020-9,63218,0.5903369191692813
589,589,2020,9,38,182,2020-9-38,2020-9,63400,0.5920364559988047
590,590,2020,9,39,216,2020-9-39,2020-9,63616,0.5940534887195578
591,591,2020,9,40,143,2020-9-40,2020-9,63759,0.5953888390856118
592,592,2020,10,40,55,2020-10-40,2020-10,63814,0.595902435380248
593,593,2020,10,41,362,2020-10-41,2020-10,64176,0.599282832810399
594,594,2020,10,42,400,2020-10-42,2020-10,64576,0.6030180785895712
595,595,2020,10,43,313,2020-10-43,2020-10,64889,0.6059409084117735
596,596,2020,10,44,92,2020-10-44,2020-10,64981,0.6068000149409831
597,597,2020,11,45,570,2020-11-45,2020-11,65551,0.6121227401763036
598,598,2020,11,46,473,2020-11-46,2020-11,66024,0.6165396683101748
599,599,2020,11,47,335,2020-11-47,2020-11,66359,0.6196679366502316
600,600,2020,11,48,133,2020-11-48,2020-11,66492,0.6209099058718064
601,601,2020,11,49,4,2020-11-49,2020-11,66496,0.6209472583295981
602,602,2020,12,49,251,2020-12-49,2020-12,66747,0.6232911250560287
603,603,2020,12,50,110,2020-12-50,2020-12,66857,0.6243183176453011
604,604,2020,12,51,403,2020-12-51,2020-12,67260,0.6280815777678171
605,605,2020,12,52,191,2020-12-52,2020-12,67451,0.6298651576273718
606,606,2020,12,53,213,2020-12-53,2020-12,67664,0.6318541760047811
607,607,2021,1,1,393,2021-1-1,2021-1,68057,0.6355240549828178
608,608,2021,1,2,448,2021-1-2,2021-1,68505,0.6397075302554908
609,609,2021,1,3,126,2021-1-3,2021-1,68631,0.64088413267593
610,610,2021,1,4,786,2021-1-4,2021-1,69417,0.6482238906320036
611,611,2021,2,5,356,2021-2-5,2021-2,69773,0.6515482593754669
612,612,2021,2,6,303,2021-2-6,2021-2,70076,0.65437770805319
613,613,2021,2,7,154,2021-2-7,2021-2,70230,0.6558157776781712
614,614,2021,2,8,240,2021-2-8,2021-2,70470,0.6580569251456746
615,615,2021,3,9,235,2021-3-9,2021-3,70705,0.6602513820409383
616,616,2021,3,10,198,2021-3-10,2021-3,70903,0.6621003287016286
617,617,2021,3,11,192,2021-3-11,2021-3,71095,0.6638932466756312
618,618,2021,3,12,307,2021-3-12,2021-3,71402,0.666760047811146
619,619,2021,3,13,141,2021-3-13,2021-3,71543,0.6680767219483043
620,620,2021,4,13,78,2021-4-13,2021-4,71621,0.6688050948752428
621,621,2021,4,14,861,2021-4-14,2021-4,72482,0.676845211414911
622,622,2021,4,15,409,2021-4-15,2021-4,72891,0.6806645002241147
623,623,2021,4,16,415,2021-4-16,2021-4,73306,0.6845398177200059
624,624,2021,4,17,349,2021-4-17,2021-4,73655,0.6877988196623338
625,625,2021,5,17,74,2021-5-17,2021-5,73729,0.6884898401314806
626,626,2021,5,18,487,2021-5-18,2021-5,74216,0.6930375018676229
627,627,2021,5,19,386,2021-5-19,2021-5,74602,0.6966420140445241
628,628,2021,5,20,382,2021-5-20,2021-5,74984,0.7002091737636337
629,629,2021,5,21,358,2021-5-21,2021-5,75342,0.7035522187359928
630,630,2021,6,22,236,2021-6-22,2021-6,75578,0.7057560137457045
631,631,2021,6,23,291,2021-6-23,2021-6,75869,0.7084734050500523
632,632,2021,6,24,335,2021-6-24,2021-6,76204,0.711601673390109
633,633,2021,6,25,574,2021-6-25,2021-6,76778,0.7169617510832212
634,634,2021,6,26,230,2021-6-26,2021-6,77008,0.7191095174062453
635,635,2021,7,26,356,2021-7-26,2021-7,77364,0.7224338861497086
636,636,2021,7,27,352,2021-7-27,2021-7,77716,0.7257209024353802
637,637,2021,7,28,585,2021-7-28,2021-7,78301,0.7311836993874197
638,638,2021,7,29,610,2021-7-29,2021-7,78911,0.7368799492006574
639,639,2021,7,30,538,2021-7-30,2021-7,79449,0.7419038547736441
640,640,2021,8,31,554,2021-8-31,2021-8,80003,0.7470771701777977
641,641,2021,8,32,382,2021-8-32,2021-8,80385,0.7506443298969072
642,642,2021,8,33,412,2021-8-33,2021-8,80797,0.7544916330494547
643,643,2021,8,34,482,2021-8-34,2021-8,81279,0.7589926042133572
644,644,2021,8,35,59,2021-8-35,2021-8,81338,0.7595435529657851
645,645,2021,9,35,255,2021-9-35,2021-9,81593,0.7619247721500074
646,646,2021,9,36,361,2021-9-36,2021-9,81954,0.7652958314657105
647,647,2021,9,37,230,2021-9-37,2021-9,82184,0.7674435977887345
648,648,2021,9,38,424,2021-9-38,2021-9,82608,0.7714029583146571
649,649,2021,9,39,320,2021-9-39,2021-9,82928,0.7743911549379949
650,650,2021,10,39,132,2021-10-39,2021-10,83060,0.7756237860451217
651,651,2021,10,40,546,2021-10-40,2021-10,83606,0.7807223965336919
652,652,2021,10,41,541,2021-10-41,2021-10,84147,0.7857743164500224
653,653,2021,10,42,263,2021-10-42,2021-10,84410,0.7882302405498282
654,654,2021,10,43,665,2021-10-43,2021-10,85075,0.794440086657702
655,655,2021,11,44,218,2021-11-44,2021-11,85293,0.7964757956073509
656,656,2021,11,45,691,2021-11-45,2021-11,85984,0.8029284326908711
657,657,2021,11,46,547,2021-11-46,2021-11,86531,0.8080363812938891
658,658,2021,11,47,150,2021-11-47,2021-11,86681,0.8094370984610787
659,659,2021,11,48,439,2021-11-48,2021-11,87120,0.8135365307037203
660,660,2021,12,48,145,2021-12-48,2021-12,87265,0.8148905572986702
661,661,2021,12,49,600,2021-12-49,2021-12,87865,0.8204934259674287
662,662,2021,12,50,503,2021-12-50,2021-12,88368,0.8251904975347378
663,663,2021,12,51,345,2021-12-51,2021-12,88713,0.8284121470192739
664,664,2021,12,52,574,2021-12-52,2021-12,89287,0.8337722247123861
665,665,2022,1,1,438,2022-1-1,2022-1,89725,0.8378623188405797
666,666,2022,1,2,558,2022-1-2,2022-1,90283,0.8430729867025251
667,667,2022,1,3,323,2022-1-3,2022-1,90606,0.8460891976692066
668,668,2022,1,4,628,2022-1-4,2022-1,91234,0.8519535335425071
669,669,2022,1,5,35,2022-1-5,2022-1,91269,0.8522803675481847
670,670,2022,2,5,266,2022-2-5,2022-2,91535,0.8547643059913342
671,671,2022,2,6,517,2022-2-6,2022-2,92052,0.8595921111609144
672,672,2022,2,7,760,2022-2-7,2022-2,92812,0.8666890781413417
673,673,2022,2,8,288,2022-2-8,2022-2,93100,0.8693784551023457
674,674,2022,2,9,51,2022-2-9,2022-2,93151,0.8698546989391902
675,675,2022,3,9,277,2022-3-9,2022-3,93428,0.872441356641267
676,676,2022,3,10,542,2022-3-10,2022-3,93970,0.8775026146720454
677,677,2022,3,11,491,2022-3-11,2022-3,94461,0.8820876288659794
678,678,2022,3,12,314,2022-3-12,2022-3,94775,0.8850197968026297
679,679,2022,3,13,414,2022-3-13,2022-3,95189,0.8888857761840729
680,680,2022,4,13,254,2022-4-13,2022-4,95443,0.8912576572538473
681,681,2022,4,14,485,2022-4-14,2022-4,95928,0.8957866427610937
682,682,2022,4,15,787,2022-4-15,2022-4,96715,0.9031357388316151
683,683,2022,4,16,277,2022-4-16,2022-4,96992,0.9057223965336919
684,684,2022,4,17,710,2022-4-17,2022-4,97702,0.9123524577917227
685,685,2022,5,18,443,2022-5-18,2022-5,98145,0.916489242492156
686,686,2022,5,19,327,2022-5-19,2022-5,98472,0.9195428059166293
687,687,2022,5,20,434,2022-5-20,2022-5,98906,0.9235955475870312
688,688,2022,5,21,647,2022-5-21,2022-5,99553,0.9296373076348424
689,689,2022,5,22,50,2022-5-22,2022-5,99603,0.9301042133572389
690,690,2022,6,22,348,2022-6-22,2022-6,99951,0.9333538771851188
691,691,2022,6,23,458,2022-6-23,2022-6,100409,0.937630733602271
692,692,2022,6,24,348,2022-6-24,2022-6,100757,0.940880397430151
693,693,2022,6,25,310,2022-6-25,2022-6,101067,0.9437752129090095
694,694,2022,6,26,796,2022-6-26,2022-6,101863,0.9512083520095622
695,695,2022,7,26,48,2022-7-26,2022-7,101911,0.9516565815030629
696,696,2022,7,27,642,2022-7-27,2022-7,102553,0.9576516509786344
697,697,2022,7,28,1115,2022-7-28,2022-7,103668,0.9680636485880771
698,698,2022,7,29,457,2022-7-29,2022-7,104125,0.9723311668907814
699,699,2022,7,30,400,2022-7-30,2022-7,104525,0.9760664126699536
700,700,2022,8,31,827,2022-8-31,2022-8,105352,0.9837890333183924
701,701,2022,8,32,529,2022-8-32,2022-8,105881,0.9887288958613477
702,702,2022,8,33,421,2022-8-33,2022-8,106302,0.9926602420439264
703,703,2022,8,34,491,2022-8-34,2022-8,106793,0.9972452562378604
704,704,2022,8,35,295,2022-8-35,2022-8,107088,1.0
