,index,year,month,week,weekly_new_reg,year-month-week,cum_reg
0,0,2010,2,7,1,2010-2-7,1
1,1,2010,3,11,1,2010-3-11,2
2,2,2010,3,13,1,2010-3-13,3
3,3,2010,4,14,1,2010-4-14,4
4,4,2010,4,17,1,2010-4-17,5
5,5,2010,5,20,1,2010-5-20,6
6,6,2010,5,21,1,2010-5-21,7
7,7,2010,6,25,1,2010-6-25,8
8,8,2010,7,28,1,2010-7-28,9
9,9,2010,7,30,1,2010-7-30,10
10,10,2010,9,39,1,2010-9-39,11
11,11,2010,10,41,2,2010-10-41,13
12,12,2010,10,43,3,2010-10-43,16
13,13,2010,12,49,1,2010-12-49,17
14,14,2010,12,51,4,2010-12-51,21
15,15,2011,1,1,1,2011-1-1,22
16,16,2011,1,2,1,2011-1-2,23
17,17,2011,1,4,4,2011-1-4,27
18,18,2011,2,5,4,2011-2-5,31
19,19,2011,2,6,1,2011-2-6,32
20,20,2011,2,7,5,2011-2-7,37
21,21,2011,2,8,3,2011-2-8,40
22,22,2011,3,9,3,2011-3-9,43
23,23,2011,3,11,2,2011-3-11,45
24,24,2011,3,12,1,2011-3-12,46
25,25,2011,3,13,4,2011-3-13,50
26,26,2011,4,13,1,2011-4-13,51
27,27,2011,4,14,5,2011-4-14,56
28,28,2011,4,15,10,2011-4-15,66
29,29,2011,4,16,13,2011-4-16,79
30,30,2011,4,17,15,2011-4-17,94
31,31,2011,5,18,11,2011-5-18,105
32,32,2011,5,19,12,2011-5-19,117
33,33,2011,5,20,20,2011-5-20,137
34,34,2011,5,21,36,2011-5-21,173
35,35,2011,5,22,1,2011-5-22,174
36,36,2011,6,22,20,2011-6-22,194
37,37,2011,6,23,46,2011-6-23,240
38,38,2011,6,24,46,2011-6-24,286
39,39,2011,6,25,40,2011-6-25,326
40,40,2011,6,26,47,2011-6-26,373
41,41,2011,7,26,4,2011-7-26,377
42,42,2011,7,27,49,2011-7-27,426
43,43,2011,7,28,70,2011-7-28,496
44,44,2011,7,29,73,2011-7-29,569
45,45,2011,7,30,29,2011-7-30,598
46,46,2011,8,31,21,2011-8-31,619
47,47,2011,8,32,40,2011-8-32,659
48,48,2011,8,33,44,2011-8-33,703
49,49,2011,8,34,28,2011-8-34,731
50,50,2011,8,35,23,2011-8-35,754
51,51,2011,9,35,7,2011-9-35,761
52,52,2011,9,36,18,2011-9-36,779
53,53,2011,9,37,16,2011-9-37,795
54,54,2011,9,38,28,2011-9-38,823
55,55,2011,9,39,46,2011-9-39,869
56,56,2011,10,40,42,2011-10-40,911
57,57,2011,10,41,37,2011-10-41,948
58,58,2011,10,42,25,2011-10-42,973
59,59,2011,10,43,23,2011-10-43,996
60,60,2011,10,44,4,2011-10-44,1000
61,61,2011,11,44,31,2011-11-44,1031
62,62,2011,11,45,20,2011-11-45,1051
63,63,2011,11,46,25,2011-11-46,1076
64,64,2011,11,47,14,2011-11-47,1090
65,65,2011,11,48,4,2011-11-48,1094
66,66,2011,12,48,11,2011-12-48,1105
67,67,2011,12,49,25,2011-12-49,1130
68,68,2011,12,50,25,2011-12-50,1155
69,69,2011,12,51,28,2011-12-51,1183
70,70,2011,12,52,19,2011-12-52,1202
71,71,2012,1,1,28,2012-1-1,1230
72,72,2012,1,2,23,2012-1-2,1253
73,73,2012,1,3,15,2012-1-3,1268
74,74,2012,1,4,18,2012-1-4,1286
75,75,2012,1,5,4,2012-1-5,1290
76,76,2012,2,5,6,2012-2-5,1296
77,77,2012,2,6,12,2012-2-6,1308
78,78,2012,2,7,8,2012-2-7,1316
79,79,2012,2,8,5,2012-2-8,1321
80,80,2012,2,9,6,2012-2-9,1327
81,81,2012,3,9,12,2012-3-9,1339
82,82,2012,3,10,21,2012-3-10,1360
83,83,2012,3,11,15,2012-3-11,1375
84,84,2012,3,12,45,2012-3-12,1420
85,85,2012,3,13,26,2012-3-13,1446
86,86,2012,4,14,38,2012-4-14,1484
87,87,2012,4,15,29,2012-4-15,1513
88,88,2012,4,16,23,2012-4-16,1536
89,89,2012,4,17,24,2012-4-17,1560
90,90,2012,4,18,3,2012-4-18,1563
91,91,2012,5,18,12,2012-5-18,1575
92,92,2012,5,19,28,2012-5-19,1603
93,93,2012,5,20,26,2012-5-20,1629
94,94,2012,5,21,36,2012-5-21,1665
95,95,2012,5,22,14,2012-5-22,1679
96,96,2012,6,23,32,2012-6-23,1711
97,97,2012,6,24,29,2012-6-24,1740
98,98,2012,6,25,32,2012-6-25,1772
99,99,2012,6,26,29,2012-6-26,1801
100,100,2012,7,27,28,2012-7-27,1829
101,101,2012,7,28,25,2012-7-28,1854
102,102,2012,7,29,29,2012-7-29,1883
103,103,2012,7,30,20,2012-7-30,1903
104,104,2012,7,31,10,2012-7-31,1913
105,105,2012,8,31,16,2012-8-31,1929
106,106,2012,8,32,51,2012-8-32,1980
107,107,2012,8,33,25,2012-8-33,2005
108,108,2012,8,34,30,2012-8-34,2035
109,109,2012,8,35,28,2012-8-35,2063
110,110,2012,9,36,30,2012-9-36,2093
111,111,2012,9,37,35,2012-9-37,2128
112,112,2012,9,38,41,2012-9-38,2169
113,113,2012,9,39,50,2012-9-39,2219
114,114,2012,10,40,42,2012-10-40,2261
115,115,2012,10,41,64,2012-10-41,2325
116,116,2012,10,42,71,2012-10-42,2396
117,117,2012,10,43,66,2012-10-43,2462
118,118,2012,10,44,41,2012-10-44,2503
119,119,2012,11,44,31,2012-11-44,2534
120,120,2012,11,45,69,2012-11-45,2603
121,121,2012,11,46,76,2012-11-46,2679
122,122,2012,11,47,35,2012-11-47,2714
123,123,2012,11,48,80,2012-11-48,2794
124,124,2012,12,1,14,2012-12-1,2808
125,125,2012,12,49,67,2012-12-49,2875
126,126,2012,12,50,58,2012-12-50,2933
127,127,2012,12,51,61,2012-12-51,2994
128,128,2012,12,52,32,2012-12-52,3026
129,129,2013,1,1,43,2013-1-1,3069
130,130,2013,1,2,117,2013-1-2,3186
131,131,2013,1,3,76,2013-1-3,3262
132,132,2013,1,4,78,2013-1-4,3340
133,133,2013,1,5,62,2013-1-5,3402
134,134,2013,2,5,12,2013-2-5,3414
135,135,2013,2,6,60,2013-2-6,3474
136,136,2013,2,7,56,2013-2-7,3530
137,137,2013,2,8,55,2013-2-8,3585
138,138,2013,2,9,56,2013-2-9,3641
139,139,2013,3,9,13,2013-3-9,3654
140,140,2013,3,10,39,2013-3-10,3693
141,141,2013,3,11,64,2013-3-11,3757
142,142,2013,3,12,46,2013-3-12,3803
143,143,2013,3,13,116,2013-3-13,3919
144,144,2013,4,14,63,2013-4-14,3982
145,145,2013,4,15,100,2013-4-15,4082
146,146,2013,4,16,105,2013-4-16,4187
147,147,2013,4,17,74,2013-4-17,4261
148,148,2013,4,18,39,2013-4-18,4300
149,149,2013,5,18,82,2013-5-18,4382
150,150,2013,5,19,110,2013-5-19,4492
151,151,2013,5,20,95,2013-5-20,4587
152,152,2013,5,21,144,2013-5-21,4731
153,153,2013,5,22,64,2013-5-22,4795
154,154,2013,6,23,125,2013-6-23,4920
155,155,2013,6,24,134,2013-6-24,5054
156,156,2013,6,25,102,2013-6-25,5156
157,157,2013,6,26,107,2013-6-26,5263
158,158,2013,7,27,67,2013-7-27,5330
159,159,2013,7,28,102,2013-7-28,5432
160,160,2013,7,29,83,2013-7-29,5515
161,161,2013,7,30,86,2013-7-30,5601
162,162,2013,7,31,46,2013-7-31,5647
163,163,2013,8,31,42,2013-8-31,5689
164,164,2013,8,32,124,2013-8-32,5813
165,165,2013,8,33,91,2013-8-33,5904
166,166,2013,8,34,84,2013-8-34,5988
167,167,2013,8,35,98,2013-8-35,6086
168,168,2013,9,36,77,2013-9-36,6163
169,169,2013,9,37,99,2013-9-37,6262
170,170,2013,9,38,134,2013-9-38,6396
171,171,2013,9,39,121,2013-9-39,6517
172,172,2013,9,40,22,2013-9-40,6539
173,173,2013,10,40,79,2013-10-40,6618
174,174,2013,10,41,139,2013-10-41,6757
175,175,2013,10,42,100,2013-10-42,6857
176,176,2013,10,43,65,2013-10-43,6922
177,177,2013,10,44,80,2013-10-44,7002
178,178,2013,11,44,22,2013-11-44,7024
179,179,2013,11,45,92,2013-11-45,7116
180,180,2013,11,46,73,2013-11-46,7189
181,181,2013,11,47,89,2013-11-47,7278
182,182,2013,11,48,51,2013-11-48,7329
183,183,2013,12,1,40,2013-12-1,7369
184,184,2013,12,49,104,2013-12-49,7473
185,185,2013,12,50,85,2013-12-50,7558
186,186,2013,12,51,97,2013-12-51,7655
187,187,2013,12,52,27,2013-12-52,7682
188,188,2014,1,1,66,2014-1-1,7748
189,189,2014,1,2,117,2014-1-2,7865
190,190,2014,1,3,82,2014-1-3,7947
191,191,2014,1,4,78,2014-1-4,8025
192,192,2014,1,5,62,2014-1-5,8087
193,193,2014,2,5,1,2014-2-5,8088
194,194,2014,2,6,51,2014-2-6,8139
195,195,2014,2,7,47,2014-2-7,8186
196,196,2014,2,8,79,2014-2-8,8265
197,197,2014,2,9,57,2014-2-9,8322
198,198,2014,3,9,1,2014-3-9,8323
199,199,2014,3,10,54,2014-3-10,8377
200,200,2014,3,11,57,2014-3-11,8434
201,201,2014,3,12,81,2014-3-12,8515
202,202,2014,3,13,77,2014-3-13,8592
203,203,2014,3,14,9,2014-3-14,8601
204,204,2014,4,14,64,2014-4-14,8665
205,205,2014,4,15,110,2014-4-15,8775
206,206,2014,4,16,70,2014-4-16,8845
207,207,2014,4,17,47,2014-4-17,8892
208,208,2014,4,18,29,2014-4-18,8921
209,209,2014,5,18,25,2014-5-18,8946
210,210,2014,5,19,52,2014-5-19,8998
211,211,2014,5,20,112,2014-5-20,9110
212,212,2014,5,21,67,2014-5-21,9177
213,213,2014,5,22,62,2014-5-22,9239
214,214,2014,6,23,112,2014-6-23,9351
215,215,2014,6,24,125,2014-6-24,9476
216,216,2014,6,25,88,2014-6-25,9564
217,217,2014,6,26,124,2014-6-26,9688
218,218,2014,6,27,18,2014-6-27,9706
219,219,2014,7,27,56,2014-7-27,9762
220,220,2014,7,28,136,2014-7-28,9898
221,221,2014,7,29,122,2014-7-29,10020
222,222,2014,7,30,71,2014-7-30,10091
223,223,2014,7,31,95,2014-7-31,10186
224,224,2014,8,31,45,2014-8-31,10231
225,225,2014,8,32,114,2014-8-32,10345
226,226,2014,8,33,71,2014-8-33,10416
227,227,2014,8,34,84,2014-8-34,10500
228,228,2014,8,35,82,2014-8-35,10582
229,229,2014,9,36,58,2014-9-36,10640
230,230,2014,9,37,90,2014-9-37,10730
231,231,2014,9,38,117,2014-9-38,10847
232,232,2014,9,39,87,2014-9-39,10934
233,233,2014,9,40,35,2014-9-40,10969
234,234,2014,10,40,54,2014-10-40,11023
235,235,2014,10,41,97,2014-10-41,11120
236,236,2014,10,42,185,2014-10-42,11305
237,237,2014,10,43,147,2014-10-43,11452
238,238,2014,10,44,146,2014-10-44,11598
239,239,2014,11,45,85,2014-11-45,11683
240,240,2014,11,46,89,2014-11-46,11772
241,241,2014,11,47,106,2014-11-47,11878
242,242,2014,11,48,56,2014-11-48,11934
243,243,2014,12,1,62,2014-12-1,11996
244,244,2014,12,49,78,2014-12-49,12074
245,245,2014,12,50,121,2014-12-50,12195
246,246,2014,12,51,87,2014-12-51,12282
247,247,2014,12,52,68,2014-12-52,12350
248,248,2015,1,1,10,2015-1-1,12360
249,249,2015,1,2,105,2015-1-2,12465
250,250,2015,1,3,101,2015-1-3,12566
251,251,2015,1,4,105,2015-1-4,12671
252,252,2015,1,5,103,2015-1-5,12774
253,253,2015,2,6,120,2015-2-6,12894
254,254,2015,2,7,41,2015-2-7,12935
255,255,2015,2,8,41,2015-2-8,12976
256,256,2015,2,9,57,2015-2-9,13033
257,257,2015,3,10,71,2015-3-10,13104
258,258,2015,3,11,66,2015-3-11,13170
259,259,2015,3,12,67,2015-3-12,13237
260,260,2015,3,13,67,2015-3-13,13304
261,261,2015,3,14,17,2015-3-14,13321
262,262,2015,4,14,78,2015-4-14,13399
263,263,2015,4,15,102,2015-4-15,13501
264,264,2015,4,16,55,2015-4-16,13556
265,265,2015,4,17,111,2015-4-17,13667
266,266,2015,4,18,98,2015-4-18,13765
267,267,2015,5,18,10,2015-5-18,13775
268,268,2015,5,19,47,2015-5-19,13822
269,269,2015,5,20,57,2015-5-20,13879
270,270,2015,5,21,113,2015-5-21,13992
271,271,2015,5,22,43,2015-5-22,14035
272,272,2015,6,23,77,2015-6-23,14112
273,273,2015,6,24,224,2015-6-24,14336
274,274,2015,6,25,77,2015-6-25,14413
275,275,2015,6,26,97,2015-6-26,14510
276,276,2015,6,27,45,2015-6-27,14555
277,277,2015,7,27,27,2015-7-27,14582
278,278,2015,7,28,73,2015-7-28,14655
279,279,2015,7,29,241,2015-7-29,14896
280,280,2015,7,30,128,2015-7-30,15024
281,281,2015,7,31,53,2015-7-31,15077
282,282,2015,8,32,54,2015-8-32,15131
283,283,2015,8,33,81,2015-8-33,15212
284,284,2015,8,34,58,2015-8-34,15270
285,285,2015,8,35,74,2015-8-35,15344
286,286,2015,8,36,13,2015-8-36,15357
287,287,2015,9,36,55,2015-9-36,15412
288,288,2015,9,37,56,2015-9-37,15468
289,289,2015,9,38,78,2015-9-38,15546
290,290,2015,9,39,64,2015-9-39,15610
291,291,2015,9,40,33,2015-9-40,15643
292,292,2015,10,40,41,2015-10-40,15684
293,293,2015,10,41,88,2015-10-41,15772
294,294,2015,10,42,79,2015-10-42,15851
295,295,2015,10,43,77,2015-10-43,15928
296,296,2015,10,44,85,2015-10-44,16013
297,297,2015,11,45,59,2015-11-45,16072
298,298,2015,11,46,92,2015-11-46,16164
299,299,2015,11,47,66,2015-11-47,16230
300,300,2015,11,48,51,2015-11-48,16281
301,301,2015,11,49,8,2015-11-49,16289
302,302,2015,12,49,74,2015-12-49,16363
303,303,2015,12,50,124,2015-12-50,16487
304,304,2015,12,51,74,2015-12-51,16561
305,305,2015,12,52,66,2015-12-52,16627
306,306,2015,12,53,82,2015-12-53,16709
307,307,2016,1,1,92,2016-1-1,16801
308,308,2016,1,2,105,2016-1-2,16906
309,309,2016,1,3,125,2016-1-3,17031
310,310,2016,1,4,70,2016-1-4,17101
311,311,2016,1,53,3,2016-1-53,17104
312,312,2016,2,5,58,2016-2-5,17162
313,313,2016,2,6,77,2016-2-6,17239
314,314,2016,2,7,77,2016-2-7,17316
315,315,2016,2,8,72,2016-2-8,17388
316,316,2016,2,9,9,2016-2-9,17397
317,317,2016,3,9,59,2016-3-9,17456
318,318,2016,3,10,55,2016-3-10,17511
319,319,2016,3,11,85,2016-3-11,17596
320,320,2016,3,12,98,2016-3-12,17694
321,321,2016,3,13,60,2016-3-13,17754
322,322,2016,4,13,7,2016-4-13,17761
323,323,2016,4,14,147,2016-4-14,17908
324,324,2016,4,15,121,2016-4-15,18029
325,325,2016,4,16,123,2016-4-16,18152
326,326,2016,4,17,99,2016-4-17,18251
327,327,2016,5,18,87,2016-5-18,18338
328,328,2016,5,19,73,2016-5-19,18411
329,329,2016,5,20,87,2016-5-20,18498
330,330,2016,5,21,76,2016-5-21,18574
331,331,2016,5,22,28,2016-5-22,18602
332,332,2016,6,22,58,2016-6-22,18660
333,333,2016,6,23,114,2016-6-23,18774
334,334,2016,6,24,111,2016-6-24,18885
335,335,2016,6,25,118,2016-6-25,19003
336,336,2016,6,26,111,2016-6-26,19114
337,337,2016,7,26,28,2016-7-26,19142
338,338,2016,7,27,85,2016-7-27,19227
339,339,2016,7,28,149,2016-7-28,19376
340,340,2016,7,29,132,2016-7-29,19508
341,341,2016,7,30,151,2016-7-30,19659
342,342,2016,8,31,185,2016-8-31,19844
343,343,2016,8,32,116,2016-8-32,19960
344,344,2016,8,33,145,2016-8-33,20105
345,345,2016,8,34,133,2016-8-34,20238
346,346,2016,8,35,53,2016-8-35,20291
347,347,2016,9,35,30,2016-9-35,20321
348,348,2016,9,36,107,2016-9-36,20428
349,349,2016,9,37,154,2016-9-37,20582
350,350,2016,9,38,119,2016-9-38,20701
351,351,2016,9,39,119,2016-9-39,20820
352,352,2016,10,39,1,2016-10-39,20821
353,353,2016,10,40,182,2016-10-40,21003
354,354,2016,10,41,127,2016-10-41,21130
355,355,2016,10,42,231,2016-10-42,21361
356,356,2016,10,43,136,2016-10-43,21497
357,357,2016,10,44,10,2016-10-44,21507
358,358,2016,11,44,101,2016-11-44,21608
359,359,2016,11,45,79,2016-11-45,21687
360,360,2016,11,46,110,2016-11-46,21797
361,361,2016,11,47,90,2016-11-47,21887
362,362,2016,11,48,39,2016-11-48,21926
363,363,2016,12,48,31,2016-12-48,21957
364,364,2016,12,49,160,2016-12-49,22117
365,365,2016,12,50,79,2016-12-50,22196
366,366,2016,12,51,137,2016-12-51,22333
367,367,2016,12,52,123,2016-12-52,22456
368,368,2017,1,1,182,2017-1-1,22638
369,369,2017,1,2,104,2017-1-2,22742
370,370,2017,1,3,156,2017-1-3,22898
371,371,2017,1,4,121,2017-1-4,23019
372,372,2017,1,5,87,2017-1-5,23106
373,373,2017,2,5,158,2017-2-5,23264
374,374,2017,2,6,145,2017-2-6,23409
375,375,2017,2,7,144,2017-2-7,23553
376,376,2017,2,8,90,2017-2-8,23643
377,377,2017,2,9,43,2017-2-9,23686
378,378,2017,3,9,79,2017-3-9,23765
379,379,2017,3,10,167,2017-3-10,23932
380,380,2017,3,11,123,2017-3-11,24055
381,381,2017,3,12,117,2017-3-12,24172
382,382,2017,3,13,148,2017-3-13,24320
383,383,2017,4,14,190,2017-4-14,24510
384,384,2017,4,15,234,2017-4-15,24744
385,385,2017,4,16,168,2017-4-16,24912
386,386,2017,4,17,152,2017-4-17,25064
387,387,2017,5,18,206,2017-5-18,25270
388,388,2017,5,19,175,2017-5-19,25445
389,389,2017,5,20,139,2017-5-20,25584
390,390,2017,5,21,172,2017-5-21,25756
391,391,2017,5,22,40,2017-5-22,25796
392,392,2017,6,22,84,2017-6-22,25880
393,393,2017,6,23,167,2017-6-23,26047
394,394,2017,6,24,230,2017-6-24,26277
395,395,2017,6,25,132,2017-6-25,26409
396,396,2017,6,26,211,2017-6-26,26620
397,397,2017,7,26,1,2017-7-26,26621
398,398,2017,7,27,147,2017-7-27,26768
399,399,2017,7,28,212,2017-7-28,26980
400,400,2017,7,29,145,2017-7-29,27125
401,401,2017,7,30,137,2017-7-30,27262
402,402,2017,7,31,19,2017-7-31,27281
403,403,2017,8,31,133,2017-8-31,27414
404,404,2017,8,32,171,2017-8-32,27585
405,405,2017,8,33,128,2017-8-33,27713
406,406,2017,8,34,120,2017-8-34,27833
407,407,2017,8,35,124,2017-8-35,27957
408,408,2017,9,35,41,2017-9-35,27998
409,409,2017,9,36,122,2017-9-36,28120
410,410,2017,9,37,156,2017-9-37,28276
411,411,2017,9,38,243,2017-9-38,28519
412,412,2017,9,39,166,2017-9-39,28685
413,413,2017,10,40,236,2017-10-40,28921
414,414,2017,10,41,183,2017-10-41,29104
415,415,2017,10,42,170,2017-10-42,29274
416,416,2017,10,43,146,2017-10-43,29420
417,417,2017,10,44,42,2017-10-44,29462
418,418,2017,11,44,61,2017-11-44,29523
419,419,2017,11,45,133,2017-11-45,29656
420,420,2017,11,46,135,2017-11-46,29791
421,421,2017,11,47,106,2017-11-47,29897
422,422,2017,11,48,134,2017-11-48,30031
423,423,2017,12,48,29,2017-12-48,30060
424,424,2017,12,49,176,2017-12-49,30236
425,425,2017,12,50,168,2017-12-50,30404
426,426,2017,12,51,138,2017-12-51,30542
427,427,2017,12,52,118,2017-12-52,30660
428,428,2018,1,1,186,2018-1-1,30846
429,429,2018,1,2,268,2018-1-2,31114
430,430,2018,1,3,173,2018-1-3,31287
431,431,2018,1,4,187,2018-1-4,31474
432,432,2018,1,5,109,2018-1-5,31583
433,433,2018,2,5,63,2018-2-5,31646
434,434,2018,2,6,122,2018-2-6,31768
435,435,2018,2,7,114,2018-2-7,31882
436,436,2018,2,8,132,2018-2-8,32014
437,437,2018,2,9,71,2018-2-9,32085
438,438,2018,3,9,45,2018-3-9,32130
439,439,2018,3,10,129,2018-3-10,32259
440,440,2018,3,11,163,2018-3-11,32422
441,441,2018,3,12,215,2018-3-12,32637
442,442,2018,3,13,235,2018-3-13,32872
443,443,2018,4,14,233,2018-4-14,33105
444,444,2018,4,15,253,2018-4-15,33358
445,445,2018,4,16,209,2018-4-16,33567
446,446,2018,4,17,156,2018-4-17,33723
447,447,2018,4,18,14,2018-4-18,33737
448,448,2018,5,18,180,2018-5-18,33917
449,449,2018,5,19,259,2018-5-19,34176
450,450,2018,5,20,243,2018-5-20,34419
451,451,2018,5,21,306,2018-5-21,34725
452,452,2018,5,22,206,2018-5-22,34931
453,453,2018,6,22,69,2018-6-22,35000
454,454,2018,6,23,352,2018-6-23,35352
455,455,2018,6,24,269,2018-6-24,35621
456,456,2018,6,25,250,2018-6-25,35871
457,457,2018,6,26,203,2018-6-26,36074
458,458,2018,7,27,147,2018-7-27,36221
459,459,2018,7,28,228,2018-7-28,36449
460,460,2018,7,29,211,2018-7-29,36660
461,461,2018,7,30,218,2018-7-30,36878
462,462,2018,7,31,49,2018-7-31,36927
463,463,2018,8,31,142,2018-8-31,37069
464,464,2018,8,32,186,2018-8-32,37255
465,465,2018,8,33,176,2018-8-33,37431
466,466,2018,8,34,157,2018-8-34,37588
467,467,2018,8,35,204,2018-8-35,37792
468,468,2018,9,36,187,2018-9-36,37979
469,469,2018,9,37,205,2018-9-37,38184
470,470,2018,9,38,234,2018-9-38,38418
471,471,2018,9,39,304,2018-9-39,38722
472,472,2018,10,40,388,2018-10-40,39110
473,473,2018,10,41,407,2018-10-41,39517
474,474,2018,10,42,346,2018-10-42,39863
475,475,2018,10,43,352,2018-10-43,40215
476,476,2018,10,44,196,2018-10-44,40411
477,477,2018,11,44,195,2018-11-44,40606
478,478,2018,11,45,374,2018-11-45,40980
479,479,2018,11,46,424,2018-11-46,41404
480,480,2018,11,47,255,2018-11-47,41659
481,481,2018,11,48,396,2018-11-48,42055
482,482,2018,12,1,23,2018-12-1,42078
483,483,2018,12,49,337,2018-12-49,42415
484,484,2018,12,50,420,2018-12-50,42835
485,485,2018,12,51,422,2018-12-51,43257
486,486,2018,12,52,275,2018-12-52,43532
487,487,2019,1,1,296,2019-1-1,43828
488,488,2019,1,2,430,2019-1-2,44258
489,489,2019,1,3,407,2019-1-3,44665
490,490,2019,1,4,387,2019-1-4,45052
491,491,2019,1,5,178,2019-1-5,45230
492,492,2019,2,5,41,2019-2-5,45271
493,493,2019,2,6,278,2019-2-6,45549
494,494,2019,2,7,142,2019-2-7,45691
495,495,2019,2,8,107,2019-2-8,45798
496,496,2019,2,9,136,2019-2-9,45934
497,497,2019,3,9,17,2019-3-9,45951
498,498,2019,3,10,133,2019-3-10,46084
499,499,2019,3,11,124,2019-3-11,46208
500,500,2019,3,12,104,2019-3-12,46312
501,501,2019,3,13,159,2019-3-13,46471
502,502,2019,4,14,184,2019-4-14,46655
503,503,2019,4,15,243,2019-4-15,46898
504,504,2019,4,16,431,2019-4-16,47329
505,505,2019,4,17,292,2019-4-17,47621
506,506,2019,4,18,73,2019-4-18,47694
507,507,2019,5,18,119,2019-5-18,47813
508,508,2019,5,19,187,2019-5-19,48000
509,509,2019,5,20,210,2019-5-20,48210
510,510,2019,5,21,224,2019-5-21,48434
511,511,2019,5,22,138,2019-5-22,48572
512,512,2019,6,23,249,2019-6-23,48821
513,513,2019,6,24,212,2019-6-24,49033
514,514,2019,6,25,284,2019-6-25,49317
515,515,2019,6,26,311,2019-6-26,49628
516,516,2019,7,27,183,2019-7-27,49811
517,517,2019,7,28,246,2019-7-28,50057
518,518,2019,7,29,378,2019-7-29,50435
519,519,2019,7,30,232,2019-7-30,50667
520,520,2019,7,31,140,2019-7-31,50807
521,521,2019,8,31,72,2019-8-31,50879
522,522,2019,8,32,117,2019-8-32,50996
523,523,2019,8,33,241,2019-8-33,51237
524,524,2019,8,34,236,2019-8-34,51473
525,525,2019,8,35,215,2019-8-35,51688
526,526,2019,9,36,231,2019-9-36,51919
527,527,2019,9,37,240,2019-9-37,52159
528,528,2019,9,38,224,2019-9-38,52383
529,529,2019,9,39,247,2019-9-39,52630
530,530,2019,9,40,10,2019-9-40,52640
531,531,2019,10,40,435,2019-10-40,53075
532,532,2019,10,41,296,2019-10-41,53371
533,533,2019,10,42,531,2019-10-42,53902
534,534,2019,10,43,282,2019-10-43,54184
535,535,2019,10,44,111,2019-10-44,54295
536,536,2019,11,44,34,2019-11-44,54329
537,537,2019,11,45,156,2019-11-45,54485
538,538,2019,11,46,114,2019-11-46,54599
539,539,2019,11,47,148,2019-11-47,54747
540,540,2019,11,48,85,2019-11-48,54832
541,541,2019,12,1,176,2019-12-1,55008
542,542,2019,12,49,126,2019-12-49,55134
543,543,2019,12,50,200,2019-12-50,55334
544,544,2019,12,51,289,2019-12-51,55623
545,545,2019,12,52,66,2019-12-52,55689
546,546,2020,1,1,141,2020-1-1,55830
547,547,2020,1,2,906,2020-1-2,56736
548,548,2020,1,3,268,2020-1-3,57004
549,549,2020,1,4,644,2020-1-4,57648
550,550,2020,1,5,129,2020-1-5,57777
551,551,2020,2,5,2,2020-2-5,57779
552,552,2020,2,6,142,2020-2-6,57921
553,553,2020,2,7,143,2020-2-7,58064
554,554,2020,2,8,130,2020-2-8,58194
555,555,2020,2,9,107,2020-2-9,58301
556,556,2020,3,10,143,2020-3-10,58444
557,557,2020,3,11,198,2020-3-11,58642
558,558,2020,3,12,221,2020-3-12,58863
559,559,2020,3,13,244,2020-3-13,59107
560,560,2020,3,14,183,2020-3-14,59290
561,561,2020,4,14,115,2020-4-14,59405
562,562,2020,4,15,292,2020-4-15,59697
563,563,2020,4,16,119,2020-4-16,59816
564,564,2020,4,17,62,2020-4-17,59878
565,565,2020,4,18,52,2020-4-18,59930
566,566,2020,5,18,14,2020-5-18,59944
567,567,2020,5,19,62,2020-5-19,60006
568,568,2020,5,20,55,2020-5-20,60061
569,569,2020,5,21,50,2020-5-21,60111
570,570,2020,5,22,77,2020-5-22,60188
571,571,2020,6,23,104,2020-6-23,60292
572,572,2020,6,24,109,2020-6-24,60401
573,573,2020,6,25,89,2020-6-25,60490
574,574,2020,6,26,190,2020-6-26,60680
575,575,2020,6,27,25,2020-6-27,60705
576,576,2020,7,27,101,2020-7-27,60806
577,577,2020,7,28,245,2020-7-28,61051
578,578,2020,7,29,362,2020-7-29,61413
579,579,2020,7,30,391,2020-7-30,61804
580,580,2020,7,31,430,2020-7-31,62234
581,581,2020,8,31,1,2020-8-31,62235
582,582,2020,8,32,282,2020-8-32,62517
583,583,2020,8,33,93,2020-8-33,62610
584,584,2020,8,34,189,2020-8-34,62799
585,585,2020,8,35,160,2020-8-35,62959
586,586,2020,8,36,18,2020-8-36,62977
587,587,2020,9,36,126,2020-9-36,63103
588,588,2020,9,37,115,2020-9-37,63218
589,589,2020,9,38,182,2020-9-38,63400
590,590,2020,9,39,216,2020-9-39,63616
591,591,2020,9,40,143,2020-9-40,63759
592,592,2020,10,40,55,2020-10-40,63814
593,593,2020,10,41,362,2020-10-41,64176
594,594,2020,10,42,400,2020-10-42,64576
595,595,2020,10,43,313,2020-10-43,64889
596,596,2020,10,44,92,2020-10-44,64981
597,597,2020,11,45,570,2020-11-45,65551
598,598,2020,11,46,473,2020-11-46,66024
599,599,2020,11,47,335,2020-11-47,66359
600,600,2020,11,48,133,2020-11-48,66492
601,601,2020,11,49,4,2020-11-49,66496
602,602,2020,12,49,251,2020-12-49,66747
603,603,2020,12,50,110,2020-12-50,66857
604,604,2020,12,51,403,2020-12-51,67260
605,605,2020,12,52,191,2020-12-52,67451
606,606,2020,12,53,213,2020-12-53,67664
607,607,2021,1,1,393,2021-1-1,68057
608,608,2021,1,2,448,2021-1-2,68505
609,609,2021,1,3,126,2021-1-3,68631
610,610,2021,1,4,786,2021-1-4,69417
611,611,2021,2,5,356,2021-2-5,69773
612,612,2021,2,6,303,2021-2-6,70076
613,613,2021,2,7,154,2021-2-7,70230
614,614,2021,2,8,240,2021-2-8,70470
615,615,2021,3,9,235,2021-3-9,70705
616,616,2021,3,10,198,2021-3-10,70903
617,617,2021,3,11,192,2021-3-11,71095
618,618,2021,3,12,307,2021-3-12,71402
619,619,2021,3,13,141,2021-3-13,71543
620,620,2021,4,13,78,2021-4-13,71621
621,621,2021,4,14,861,2021-4-14,72482
622,622,2021,4,15,409,2021-4-15,72891
623,623,2021,4,16,415,2021-4-16,73306
624,624,2021,4,17,349,2021-4-17,73655
625,625,2021,5,17,74,2021-5-17,73729
626,626,2021,5,18,487,2021-5-18,74216
627,627,2021,5,19,386,2021-5-19,74602
628,628,2021,5,20,382,2021-5-20,74984
629,629,2021,5,21,358,2021-5-21,75342
630,630,2021,6,22,236,2021-6-22,75578
631,631,2021,6,23,291,2021-6-23,75869
632,632,2021,6,24,335,2021-6-24,76204
633,633,2021,6,25,574,2021-6-25,76778
634,634,2021,6,26,230,2021-6-26,77008
635,635,2021,7,26,356,2021-7-26,77364
636,636,2021,7,27,352,2021-7-27,77716
637,637,2021,7,28,585,2021-7-28,78301
638,638,2021,7,29,610,2021-7-29,78911
639,639,2021,7,30,538,2021-7-30,79449
640,640,2021,8,31,554,2021-8-31,80003
641,641,2021,8,32,382,2021-8-32,80385
642,642,2021,8,33,412,2021-8-33,80797
643,643,2021,8,34,482,2021-8-34,81279
644,644,2021,8,35,59,2021-8-35,81338
645,645,2021,9,35,255,2021-9-35,81593
646,646,2021,9,36,361,2021-9-36,81954
647,647,2021,9,37,230,2021-9-37,82184
648,648,2021,9,38,424,2021-9-38,82608
649,649,2021,9,39,320,2021-9-39,82928
650,650,2021,10,39,132,2021-10-39,83060
651,651,2021,10,40,546,2021-10-40,83606
652,652,2021,10,41,541,2021-10-41,84147
653,653,2021,10,42,263,2021-10-42,84410
654,654,2021,10,43,665,2021-10-43,85075
655,655,2021,11,44,218,2021-11-44,85293
656,656,2021,11,45,691,2021-11-45,85984
657,657,2021,11,46,547,2021-11-46,86531
658,658,2021,11,47,150,2021-11-47,86681
659,659,2021,11,48,439,2021-11-48,87120
660,660,2021,12,48,145,2021-12-48,87265
661,661,2021,12,49,600,2021-12-49,87865
662,662,2021,12,50,503,2021-12-50,88368
663,663,2021,12,51,345,2021-12-51,88713
664,664,2021,12,52,574,2021-12-52,89287
665,665,2022,1,1,438,2022-1-1,89725
666,666,2022,1,2,558,2022-1-2,90283
667,667,2022,1,3,323,2022-1-3,90606
668,668,2022,1,4,628,2022-1-4,91234
669,669,2022,1,5,35,2022-1-5,91269
670,670,2022,2,5,266,2022-2-5,91535
671,671,2022,2,6,517,2022-2-6,92052
672,672,2022,2,7,760,2022-2-7,92812
673,673,2022,2,8,288,2022-2-8,93100
674,674,2022,2,9,51,2022-2-9,93151
675,675,2022,3,9,277,2022-3-9,93428
676,676,2022,3,10,542,2022-3-10,93970
677,677,2022,3,11,491,2022-3-11,94461
678,678,2022,3,12,314,2022-3-12,94775
679,679,2022,3,13,414,2022-3-13,95189
680,680,2022,4,13,254,2022-4-13,95443
681,681,2022,4,14,485,2022-4-14,95928
682,682,2022,4,15,787,2022-4-15,96715
683,683,2022,4,16,277,2022-4-16,96992
684,684,2022,4,17,710,2022-4-17,97702
685,685,2022,5,18,443,2022-5-18,98145
686,686,2022,5,19,327,2022-5-19,98472
687,687,2022,5,20,434,2022-5-20,98906
688,688,2022,5,21,647,2022-5-21,99553
689,689,2022,5,22,50,2022-5-22,99603
690,690,2022,6,22,348,2022-6-22,99951
691,691,2022,6,23,458,2022-6-23,100409
692,692,2022,6,24,348,2022-6-24,100757
693,693,2022,6,25,310,2022-6-25,101067
694,694,2022,6,26,796,2022-6-26,101863
695,695,2022,7,26,48,2022-7-26,101911
696,696,2022,7,27,642,2022-7-27,102553
697,697,2022,7,28,1115,2022-7-28,103668
698,698,2022,7,29,457,2022-7-29,104125
699,699,2022,7,30,400,2022-7-30,104525
700,700,2022,8,31,827,2022-8-31,105352
701,701,2022,8,32,529,2022-8-32,105881
702,702,2022,8,33,421,2022-8-33,106302
703,703,2022,8,34,491,2022-8-34,106793
704,704,2022,8,35,295,2022-8-35,107088
